1111111111111111111111111111111111111111111111
1000000000000000000111110000000010000000000001
1111111100000000000111000000000010000000000001
1000000000000000000111110000000010000000000001
1000000000000000000000000000000010000000000001
1000000000000000000000000000000010000000000001
0000001111111111111111111000000010000000000001
1000001000000000000000000000000010000000000001
1000001000000000000000000000000010000000000001
1000001333330000000000000000000010000000000001
1111101111111111111111111111111111111111111111